WWWWWWWWWWWWWWWW
W.....W...W....W
WWWW..W...WD...W
W..............W
W...W.....W....W
W...W..F..W....W
W...W.....W....W
W...WWWWWWWWWWWW
W...W..........W
W.........W....W
W...W.....WC...W
WWWWWWWWWWWWWWWW