WWWWWWWWWWWWWWWW
W........W.....W
W....w...W...w.W
WWW....W....WWWW
W.W...W.....W..W
W.W...W.W.W....W
W.....W.....w..W
W...........WWWW
W...w..........W
W..W.....Ww....W
W..w...W.W.....W
WWWWWWWWWWWWWWWW