WWWWWWWWWWWWWWWW
W.q...W........W
WW....W..W..W..W
W..WWW.....W...W
W.....W.W.WWW..W
W..W.WW...W....W
W...WW..W.W....W
W....W....W....W
W..WWWW.....W..W
WW.......WW....W
W....W....W....W
WWWWWWWWWWWWWWWW