WWWWWWWWWWWWWWWW
W....WV....W...W
W....W.........W
WWWW.WWWW..W...W
W..W.W.....W...W
W..W.W.....W...W
W..W.WWWWWWW...W
W..............W
WW..WWWWWWWW.WWW
W...W.....W....W
W.........W....W
WWWWWWWWWWWWWWWW