WWWWWWWWWWWWWWWW
W..............W
WW....W..W..W..W
W..WWW.....W...W
W.....W.W.WWW..W
W..W.WW...W....W
W...WW..W.W....W
W....W....W....W
W...WWW.....W..W
WW.......WW....W
W....W....W....W
WWWWWWWWWWWWWWWW